#############################################
#         #                        #        #
#         #                        #        #
#                                           #
#              ###  ####                   e#
#         #    #       #           #        #
#         #    #       #           #        #
#      #######################     #        #
#      #                     #     #        #
#                          o ##   #####  ####
#                 #          #      t       #
#      #          #          #              #
########          #          #              #
#                 #          #              #
#                 #          #              #
#      #                     #              #
#      #                     #              #
#      #                     #              #
#      #######################              #
#      #         #           #              #
#      #         #           #              #
#      #         #           #              #
#                                           #
#                                           #
#      #         #           #              #
#      #         #           #      s       #
############################################# 